######################################################
#                                                    #
#   ################# ###################### #########
#                                                    #
# ########################### ########################
#                 @                                  #
## ####################################  ########### #
#                                                    #
######################### #########################  #
#                                                    #
# ################### ############################## #
#                    $                               #
######################################## #############
#                                                    #
# ################# ################################ #
#                                                    #
########### ############################## ###########
#                                                    #
# ####### ###################### ########## ##########
#                                                    #
######################################### ############
#                                                    #
# ######################### #######################  #
#                                                    #
######################################################